16|16|16|16|16|16|
16|00|01|02|03|16|
16|04|05|06|07|16|
16|08|09|10|11|16|
16|12|13|14|15|16|
16|16|16|16|16|16|
